+++++++++++++++++++++++++++++++++++++
+++++++++++++++++++++++++++++++++++++
++++++ a a ++++++++++++++++++++++++++
++++++  0  ++++++++++++++++++++++++++
++++++     ++++++++++++++++++++++++++
++++++AAAAA++++++++++++++++++++++++++
++++++     ++++++++++++++++++++++++++
+++++++++++++++++++++++++++++++++++++
+++    A A    +++++++++++++++++++++++
+++  + A A +  +++++++++++++++++++++++
+++  + A A +  +++++++++++++++++++++++
+++  + A A +  +++++++++++++++++++++++
+AAAAAAAAAAAAAAA+++++++++++++++++++++
+++++++++++++++++++++++++++++++++++++
+++++++++++++++++++++++++++++++++++++
