+++++++++++++++++++++++++++++++++++++
+++++++++++++++++++++++++++++++++++++
+++++++++++++++++++++++++++++++++++++
++++++AAAAAAA++++++++++++++++++++++++
++++++       ++++++++++++++++++++++++
++++++       ++++++++++++++++++++++++
++++++  a0a  ++++++++++++++++++++++++
++++++       ++++++++++++++++++++++++
++++++       ++++++++++++++++++++++++
++++++AAAAAAA++++++++++++++++++++++++
+++++++++++++++++++++++++++++++++++++
+++++++++++++++++++++++++++++++++++++
+++++++++++++++++++++++++++++++++++++
+++++++++++++++++++++++++++++++++++++
