++++++++++++++++++
+                +
+                +
+                +
+                +
+                +
+    aA  0  Aa   +
+                +
+                +
+                +
+                +
+                +
++++++++++++++++++
