blue: 0,1,E,F,G
red: 2,A,B
green: 3,C,D
++++++++++++++++++++++
+2   D ab+     +ef+  +
+ +++C+++++++  +g    +
+   + +        +++++ +
+   +++           G+ +
+    +      +++++FE+ +
+    +          ++++ +
+         01         +
+ ++++          +    +
+ +EF+++++      +    +
+ +G           +++   +
+ +++++        + +   +
+    g+  +++++++B+++ +
+  +fe+     +cd A   3+
++++++++++++++++++++++

